F 220,100,0
NO ./path_to_the_north_texture
C 225,30,0
WE ./path_to_the_west_texture
SO ./path_to_the_south_texture
EA ./path_to_the_east_texture


1111111111111111111111111
1000000000110000000000001
1011000001110000000000001
100100000000000000000000111111111
111111111111111111110000000000001
10000001         1110111111111111
11110111         100000010001
11110111         101010010001
11000000111111111100000010001
10000000000000001100000010001
10000001 10000001 11010100N10001
1100000111010101111101111111111
11110111 1110101 101111010001
11111111 1111111 111111111111