SO ./textures_xpm/naturalbricks_hd_middle.xpm
NO ./textures_xpm/naturalbricks_hd_verydark.xpm
EA ./textures_xpm/naturalbricks_hd_middle.xpm
WE ./textures_xpm/naturalbricks_hd_middle.xpm

F 111,111,111
C 155,100,160

1111111111111111111111111111111111
1000000000000000101111111111101111
101000001000001011111111111111
10000000000000001
10001000100010001
10000000000000001
10101010001010101
10000000000000001
10001000100100001
1000000N010000001
10100000100001001
10000000000000001
10000000000000001
11111111101111111
10000000000000001
10100000100000101
10000000000000001
10001000100010001
10000000000000001
10101010001010101
10000000000000001
10001000100100001
10000000000000001
10100000100001001
11111111111111111       1111111111111
11111111111111111
