SO ./textures/wall_so.xpm
NO ./textures/wall_no.xpm
EA ./textures/wall_ea.xpm
WE ./textures/wall_we.xpm

F 90,090,090
C 220,220,220

1111111111111111111111111
1000000000000000011100001
1000000000000000001100001
1000000000000000000010001
1000000000000000000000001
1000000000000000000000001
1010101000101010000000001
1000000000000000000000101
1000100010010000000011001
1000000N01000000001110001
1010000010000000100100001
1000000000000011001000001
1000000000001100000000001
1111111111111111111111111
